80
60
mona_lisa_overdive.mp3
(0,0,255)
(255,0,0)
(255,255,0)
(0,255,0)
(255,255,255)
(255,0,255)
(255,130,130)
@
********************************************************************************
*_____________________________________________________________________________P*
*______________________________________________________________________________*
*______________________________________________________________________________*
*______________________________________________________________________________*
*______________________________________________________________________________*
*______________________________________________________________________________*
*______________________________________________________________________________*
*______________________________________________________________________________*
*______________________________________________________________________________*
*_________________________________P_____________________________________________*
*______________________________________________________________________________*
*______________________________________________________________________________*
*______________________________________________________________________________*
*______________________________________________________________________________*
*______________________________________________________________________________*
*______________________________________________________________________________*
*______________________________________________________________________________*
*______________________________________________________________________________*
*______________________________________________________________________________*
*______________________________________________________________________________*
*______________________________________________________________________________*
*______________________________________________________________________________*
*______________________________________________________________________________*
*______________________________________________________________________________*
*______________________________________________________________________________*
*______________________________________________________________________________*
*______________________________________________________________________________*
*______________________________________________________________________________*
*______________________________________________________________________________*
*______________________________________________________________________________*
*______________________________________________________________________________*
*_____________________________________^________________________________________*
*______________________________________________________________________________*
*______________________________________________________________________________*
*______________________________________________________________________________*
*______________________________________________________________________________*
*______________________________________________________________________________*
*______________________________________________________________________________*
*______________________________________________________________________________*
*______________________________________________________________________________*
*______________________________________________________________________________*
*______________________________________________________________________________*
*______________________________________________________________________________*
*______________________________________________________________________________*
*______________________________________________________________________________*
*______________________________________________________________________________*
*______________________________________________________________________________*
*______________________________________________________________________________*
*______________________________________________________________________________*
*______________________________________________________________________________*
*______________________________________________________________________________*
*______________________________________________________________________________*
*______________________________________________________________________________*
*______________________________________________________________________________*
*______________________________________________________________________________*
*______________________________________________________________________________*
*______________________________________________________________________________*
*P____________________________________________________________________________P*
********************************************************************************
